"filename", "language", "JavaScript", "JSON", "CSS", "XML", "comment", "blank", "total"
"c:\Users\abese\Desktop\PROJECTS\FINANCE\frontend\Website\react\src\App.js", "JavaScript", 147, 0, 0, 0, 29, 24, 200
"c:\Users\abese\Desktop\PROJECTS\FINANCE\frontend\Website\react\src\api.js", "JavaScript", 5, 0, 0, 0, 0, 3, 8
"c:\Users\abese\Desktop\PROJECTS\FINANCE\frontend\Website\react\src\assets\images\Logo.svg", "XML", 0, 0, 0, 1, 0, 0, 1
"c:\Users\abese\Desktop\PROJECTS\FINANCE\frontend\Website\react\src\assets\images\illustrations\pattern-tree.svg", "XML", 0, 0, 0, 20, 0, 0, 20
"c:\Users\abese\Desktop\PROJECTS\FINANCE\frontend\Website\react\src\assets\images\logos\gray-logos\logo-coinbase.svg", "XML", 0, 0, 0, 16, 0, 0, 16
"c:\Users\abese\Desktop\PROJECTS\FINANCE\frontend\Website\react\src\assets\images\logos\gray-logos\logo-nasa.svg", "XML", 0, 0, 0, 9, 0, 0, 9
"c:\Users\abese\Desktop\PROJECTS\FINANCE\frontend\Website\react\src\assets\images\logos\gray-logos\logo-netflix.svg", "XML", 0, 0, 0, 9, 0, 0, 9
"c:\Users\abese\Desktop\PROJECTS\FINANCE\frontend\Website\react\src\assets\images\logos\gray-logos\logo-pinterest.svg", "XML", 0, 0, 0, 9, 0, 0, 9
"c:\Users\abese\Desktop\PROJECTS\FINANCE\frontend\Website\react\src\assets\images\logos\gray-logos\logo-spotify.svg", "XML", 0, 0, 0, 9, 0, 0, 9
"c:\Users\abese\Desktop\PROJECTS\FINANCE\frontend\Website\react\src\assets\images\logos\gray-logos\logo-vodafone.svg", "XML", 0, 0, 0, 9, 0, 0, 9
"c:\Users\abese\Desktop\PROJECTS\FINANCE\frontend\Website\react\src\assets\images\small-logos\bootstrap.svg", "XML", 0, 0, 0, 9, 0, 0, 9
"c:\Users\abese\Desktop\PROJECTS\FINANCE\frontend\Website\react\src\assets\images\small-logos\creative-tim.svg", "XML", 0, 0, 0, 7, 0, 0, 7
"c:\Users\abese\Desktop\PROJECTS\FINANCE\frontend\Website\react\src\assets\images\small-logos\devto.svg", "XML", 0, 0, 0, 9, 0, 0, 9
"c:\Users\abese\Desktop\PROJECTS\FINANCE\frontend\Website\react\src\assets\images\small-logos\github.svg", "XML", 0, 0, 0, 10, 0, 0, 10
"c:\Users\abese\Desktop\PROJECTS\FINANCE\frontend\Website\react\src\assets\images\small-logos\google-webdev.svg", "XML", 0, 0, 0, 11, 0, 0, 11
"c:\Users\abese\Desktop\PROJECTS\FINANCE\frontend\Website\react\src\assets\images\small-logos\icon-bulb.svg", "XML", 0, 0, 0, 37, 0, 0, 37
"c:\Users\abese\Desktop\PROJECTS\FINANCE\frontend\Website\react\src\assets\images\small-logos\logo-asana.svg", "XML", 0, 0, 0, 16, 0, 0, 16
"c:\Users\abese\Desktop\PROJECTS\FINANCE\frontend\Website\react\src\assets\images\small-logos\logo-atlassian.svg", "XML", 0, 0, 0, 16, 0, 0, 16
"c:\Users\abese\Desktop\PROJECTS\FINANCE\frontend\Website\react\src\assets\images\small-logos\logo-invision.svg", "XML", 0, 0, 0, 10, 0, 0, 10
"c:\Users\abese\Desktop\PROJECTS\FINANCE\frontend\Website\react\src\assets\images\small-logos\logo-jira.svg", "XML", 0, 0, 0, 21, 0, 0, 21
"c:\Users\abese\Desktop\PROJECTS\FINANCE\frontend\Website\react\src\assets\images\small-logos\logo-slack.svg", "XML", 0, 0, 0, 12, 0, 0, 12
"c:\Users\abese\Desktop\PROJECTS\FINANCE\frontend\Website\react\src\assets\images\small-logos\logo-spotify.svg", "XML", 0, 0, 0, 9, 0, 0, 9
"c:\Users\abese\Desktop\PROJECTS\FINANCE\frontend\Website\react\src\assets\images\small-logos\logo-xd.svg", "XML", 0, 0, 0, 11, 0, 0, 11
"c:\Users\abese\Desktop\PROJECTS\FINANCE\frontend\Website\react\src\assets\theme-dark\base\borders.js", "JavaScript", 25, 0, 0, 0, 21, 9, 55
"c:\Users\abese\Desktop\PROJECTS\FINANCE\frontend\Website\react\src\assets\theme-dark\base\boxShadows.js", "JavaScript", 90, 0, 0, 0, 21, 8, 119
"c:\Users\abese\Desktop\PROJECTS\FINANCE\frontend\Website\react\src\assets\theme-dark\base\breakpoints.js", "JavaScript", 11, 0, 0, 0, 19, 4, 34
"c:\Users\abese\Desktop\PROJECTS\FINANCE\frontend\Website\react\src\assets\theme-dark\base\colors.js", "JavaScript", 199, 0, 0, 0, 19, 48, 266
"c:\Users\abese\Desktop\PROJECTS\FINANCE\frontend\Website\react\src\assets\theme-dark\base\globals.js", "JavaScript", 22, 0, 0, 0, 15, 5, 42
"c:\Users\abese\Desktop\PROJECTS\FINANCE\frontend\Website\react\src\assets\theme-dark\base\typography.js", "JavaScript", 148, 0, 0, 0, 21, 31, 200
"c:\Users\abese\Desktop\PROJECTS\FINANCE\frontend\Website\react\src\assets\theme-dark\components\appBar.js", "JavaScript", 11, 0, 0, 0, 14, 4, 29
"c:\Users\abese\Desktop\PROJECTS\FINANCE\frontend\Website\react\src\assets\theme-dark\components\avatar.js", "JavaScript", 16, 0, 0, 0, 15, 7, 38
"c:\Users\abese\Desktop\PROJECTS\FINANCE\frontend\Website\react\src\assets\theme-dark\components\breadcrumbs.js", "JavaScript", 16, 0, 0, 0, 15, 6, 37
"c:\Users\abese\Desktop\PROJECTS\FINANCE\frontend\Website\react\src\assets\theme-dark\components\buttonBase.js", "JavaScript", 6, 0, 0, 0, 14, 3, 23
"c:\Users\abese\Desktop\PROJECTS\FINANCE\frontend\Website\react\src\assets\theme-dark\components\button\contained.js", "JavaScript", 57, 0, 0, 0, 16, 19, 92
"c:\Users\abese\Desktop\PROJECTS\FINANCE\frontend\Website\react\src\assets\theme-dark\components\button\index.js", "JavaScript", 28, 0, 0, 0, 15, 4, 47
"c:\Users\abese\Desktop\PROJECTS\FINANCE\frontend\Website\react\src\assets\theme-dark\components\button\outlined.js", "JavaScript", 51, 0, 0, 0, 16, 16, 83
"c:\Users\abese\Desktop\PROJECTS\FINANCE\frontend\Website\react\src\assets\theme-dark\components\button\root.js", "JavaScript", 30, 0, 0, 0, 16, 8, 54
"c:\Users\abese\Desktop\PROJECTS\FINANCE\frontend\Website\react\src\assets\theme-dark\components\button\text.js", "JavaScript", 68, 0, 0, 0, 16, 21, 105
"c:\Users\abese\Desktop\PROJECTS\FINANCE\frontend\Website\react\src\assets\theme-dark\components\card\cardContent.js", "JavaScript", 11, 0, 0, 0, 15, 4, 30
"c:\Users\abese\Desktop\PROJECTS\FINANCE\frontend\Website\react\src\assets\theme-dark\components\card\cardMedia.js", "JavaScript", 15, 0, 0, 0, 16, 7, 38
"c:\Users\abese\Desktop\PROJECTS\FINANCE\frontend\Website\react\src\assets\theme-dark\components\card\index.js", "JavaScript", 26, 0, 0, 0, 16, 6, 48
"c:\Users\abese\Desktop\PROJECTS\FINANCE\frontend\Website\react\src\assets\theme-dark\components\container.js", "JavaScript", 51, 0, 0, 0, 16, 8, 75
"c:\Users\abese\Desktop\PROJECTS\FINANCE\frontend\Website\react\src\assets\theme-dark\components\dialog\dialogActions.js", "JavaScript", 9, 0, 0, 0, 15, 4, 28
"c:\Users\abese\Desktop\PROJECTS\FINANCE\frontend\Website\react\src\assets\theme-dark\components\dialog\dialogContent.js", "JavaScript", 22, 0, 0, 0, 16, 7, 45
"c:\Users\abese\Desktop\PROJECTS\FINANCE\frontend\Website\react\src\assets\theme-dark\components\dialog\dialogContentText.js", "JavaScript", 14, 0, 0, 0, 16, 6, 36
"c:\Users\abese\Desktop\PROJECTS\FINANCE\frontend\Website\react\src\assets\theme-dark\components\dialog\dialogTitle.js", "JavaScript", 12, 0, 0, 0, 16, 6, 34
"c:\Users\abese\Desktop\PROJECTS\FINANCE\frontend\Website\react\src\assets\theme-dark\components\dialog\index.js", "JavaScript", 16, 0, 0, 0, 15, 6, 37
"c:\Users\abese\Desktop\PROJECTS\FINANCE\frontend\Website\react\src\assets\theme-dark\components\divider.js", "JavaScript", 44, 0, 0, 0, 16, 9, 69
"c:\Users\abese\Desktop\PROJECTS\FINANCE\frontend\Website\react\src\assets\theme-dark\components\form\autocomplete.js", "JavaScript", 76, 0, 0, 0, 16, 18, 110
"c:\Users\abese\Desktop\PROJECTS\FINANCE\frontend\Website\react\src\assets\theme-dark\components\form\checkbox.js", "JavaScript", 55, 0, 0, 0, 16, 13, 84
"c:\Users\abese\Desktop\PROJECTS\FINANCE\frontend\Website\react\src\assets\theme-dark\components\form\formControlLabel.js", "JavaScript", 27, 0, 0, 0, 16, 8, 51
"c:\Users\abese\Desktop\PROJECTS\FINANCE\frontend\Website\react\src\assets\theme-dark\components\form\formLabel.js", "JavaScript", 10, 0, 0, 0, 15, 5, 30
"c:\Users\abese\Desktop\PROJECTS\FINANCE\frontend\Website\react\src\assets\theme-dark\components\form\input.js", "JavaScript", 31, 0, 0, 0, 16, 11, 58
"c:\Users\abese\Desktop\PROJECTS\FINANCE\frontend\Website\react\src\assets\theme-dark\components\form\inputLabel.js", "JavaScript", 35, 0, 0, 0, 15, 11, 61
"c:\Users\abese\Desktop\PROJECTS\FINANCE\frontend\Website\react\src\assets\theme-dark\components\form\inputOutlined.js", "JavaScript", 45, 0, 0, 0, 16, 13, 74
"c:\Users\abese\Desktop\PROJECTS\FINANCE\frontend\Website\react\src\assets\theme-dark\components\form\radio.js", "JavaScript", 65, 0, 0, 0, 16, 17, 98
"c:\Users\abese\Desktop\PROJECTS\FINANCE\frontend\Website\react\src\assets\theme-dark\components\form\select.js", "JavaScript", 25, 0, 0, 0, 16, 9, 50
"c:\Users\abese\Desktop\PROJECTS\FINANCE\frontend\Website\react\src\assets\theme-dark\components\form\switchButton.js", "JavaScript", 55, 0, 0, 0, 17, 17, 89
"c:\Users\abese\Desktop\PROJECTS\FINANCE\frontend\Website\react\src\assets\theme-dark\components\form\textField.js", "JavaScript", 10, 0, 0, 0, 15, 5, 30
"c:\Users\abese\Desktop\PROJECTS\FINANCE\frontend\Website\react\src\assets\theme-dark\components\icon.js", "JavaScript", 19, 0, 0, 0, 15, 7, 41
"c:\Users\abese\Desktop\PROJECTS\FINANCE\frontend\Website\react\src\assets\theme-dark\components\iconButton.js", "JavaScript", 12, 0, 0, 0, 15, 5, 32
"c:\Users\abese\Desktop\PROJECTS\FINANCE\frontend\Website\react\src\assets\theme-dark\components\linearProgress.js", "JavaScript", 29, 0, 0, 0, 16, 9, 54
"c:\Users\abese\Desktop\PROJECTS\FINANCE\frontend\Website\react\src\assets\theme-dark\components\link.js", "JavaScript", 7, 0, 0, 0, 14, 3, 24
"c:\Users\abese\Desktop\PROJECTS\FINANCE\frontend\Website\react\src\assets\theme-dark\components\list\index.js", "JavaScript", 9, 0, 0, 0, 14, 3, 26
"c:\Users\abese\Desktop\PROJECTS\FINANCE\frontend\Website\react\src\assets\theme-dark\components\list\listItem.js", "JavaScript", 12, 0, 0, 0, 14, 4, 30
"c:\Users\abese\Desktop\PROJECTS\FINANCE\frontend\Website\react\src\assets\theme-dark\components\list\listItemText.js", "JavaScript", 9, 0, 0, 0, 14, 3, 26
"c:\Users\abese\Desktop\PROJECTS\FINANCE\frontend\Website\react\src\assets\theme-dark\components\menu\index.js", "JavaScript", 27, 0, 0, 0, 16, 7, 50
"c:\Users\abese\Desktop\PROJECTS\FINANCE\frontend\Website\react\src\assets\theme-dark\components\menu\menuItem.js", "JavaScript", 26, 0, 0, 0, 16, 7, 49
"c:\Users\abese\Desktop\PROJECTS\FINANCE\frontend\Website\react\src\assets\theme-dark\components\popover.js", "JavaScript", 18, 0, 0, 0, 16, 6, 40
"c:\Users\abese\Desktop\PROJECTS\FINANCE\frontend\Website\react\src\assets\theme-dark\components\sidenav.js", "JavaScript", 26, 0, 0, 0, 16, 8, 50
"c:\Users\abese\Desktop\PROJECTS\FINANCE\frontend\Website\react\src\assets\theme-dark\components\slider.js", "JavaScript", 46, 0, 0, 0, 16, 12, 74
"c:\Users\abese\Desktop\PROJECTS\FINANCE\frontend\Website\react\src\assets\theme-dark\components\stepper\index.js", "JavaScript", 22, 0, 0, 0, 16, 7, 45
"c:\Users\abese\Desktop\PROJECTS\FINANCE\frontend\Website\react\src\assets\theme-dark\components\stepper\step.js", "JavaScript", 9, 0, 0, 0, 15, 4, 28
"c:\Users\abese\Desktop\PROJECTS\FINANCE\frontend\Website\react\src\assets\theme-dark\components\stepper\stepConnector.js", "JavaScript", 29, 0, 0, 0, 15, 9, 53
"c:\Users\abese\Desktop\PROJECTS\FINANCE\frontend\Website\react\src\assets\theme-dark\components\stepper\stepIcon.js", "JavaScript", 34, 0, 0, 0, 16, 8, 58
"c:\Users\abese\Desktop\PROJECTS\FINANCE\frontend\Website\react\src\assets\theme-dark\components\stepper\stepLabel.js", "JavaScript", 26, 0, 0, 0, 16, 8, 50
"c:\Users\abese\Desktop\PROJECTS\FINANCE\frontend\Website\react\src\assets\theme-dark\components\svgIcon.js", "JavaScript", 18, 0, 0, 0, 15, 7, 40
"c:\Users\abese\Desktop\PROJECTS\FINANCE\frontend\Website\react\src\assets\theme-dark\components\table\tableCell.js", "JavaScript", 14, 0, 0, 0, 16, 6, 36
"c:\Users\abese\Desktop\PROJECTS\FINANCE\frontend\Website\react\src\assets\theme-dark\components\table\tableContainer.js", "JavaScript", 16, 0, 0, 0, 15, 5, 36
"c:\Users\abese\Desktop\PROJECTS\FINANCE\frontend\Website\react\src\assets\theme-dark\components\table\tableHead.js", "JavaScript", 13, 0, 0, 0, 16, 6, 35
"c:\Users\abese\Desktop\PROJECTS\FINANCE\frontend\Website\react\src\assets\theme-dark\components\tabs\index.js", "JavaScript", 40, 0, 0, 0, 16, 10, 66
"c:\Users\abese\Desktop\PROJECTS\FINANCE\frontend\Website\react\src\assets\theme-dark\components\tabs\tab.js", "JavaScript", 41, 0, 0, 0, 16, 9, 66
"c:\Users\abese\Desktop\PROJECTS\FINANCE\frontend\Website\react\src\assets\theme-dark\components\tooltip.js", "JavaScript", 31, 0, 0, 0, 17, 9, 57
"c:\Users\abese\Desktop\PROJECTS\FINANCE\frontend\Website\react\src\assets\theme-dark\functions\boxShadow.js", "JavaScript", 11, 0, 0, 0, 18, 6, 35
"c:\Users\abese\Desktop\PROJECTS\FINANCE\frontend\Website\react\src\assets\theme-dark\functions\gradientChartLine.js", "JavaScript", 11, 0, 0, 0, 18, 7, 36
"c:\Users\abese\Desktop\PROJECTS\FINANCE\frontend\Website\react\src\assets\theme-dark\functions\hexToRgb.js", "JavaScript", 5, 0, 0, 0, 19, 5, 29
"c:\Users\abese\Desktop\PROJECTS\FINANCE\frontend\Website\react\src\assets\theme-dark\functions\linearGradient.js", "JavaScript", 4, 0, 0, 0, 17, 4, 25
"c:\Users\abese\Desktop\PROJECTS\FINANCE\frontend\Website\react\src\assets\theme-dark\functions\pxToRem.js", "JavaScript", 4, 0, 0, 0, 17, 4, 25
"c:\Users\abese\Desktop\PROJECTS\FINANCE\frontend\Website\react\src\assets\theme-dark\functions\rgba.js", "JavaScript", 5, 0, 0, 0, 19, 5, 29
"c:\Users\abese\Desktop\PROJECTS\FINANCE\frontend\Website\react\src\assets\theme-dark\index.js", "JavaScript", 133, 0, 0, 0, 19, 7, 159
"c:\Users\abese\Desktop\PROJECTS\FINANCE\frontend\Website\react\src\assets\theme-dark\theme-rtl.js", "JavaScript", 134, 0, 0, 0, 19, 7, 160
"c:\Users\abese\Desktop\PROJECTS\FINANCE\frontend\Website\react\src\assets\theme\base\borders.js", "JavaScript", 24, 0, 0, 0, 21, 9, 54
"c:\Users\abese\Desktop\PROJECTS\FINANCE\frontend\Website\react\src\assets\theme\base\boxShadows.js", "JavaScript", 90, 0, 0, 0, 21, 8, 119
"c:\Users\abese\Desktop\PROJECTS\FINANCE\frontend\Website\react\src\assets\theme\base\breakpoints.js", "JavaScript", 11, 0, 0, 0, 19, 4, 34
"c:\Users\abese\Desktop\PROJECTS\FINANCE\frontend\Website\react\src\assets\theme\base\colors.js", "JavaScript", 197, 0, 0, 0, 19, 48, 264
"c:\Users\abese\Desktop\PROJECTS\FINANCE\frontend\Website\react\src\assets\theme\base\globals.js", "JavaScript", 22, 0, 0, 0, 15, 5, 42
"c:\Users\abese\Desktop\PROJECTS\FINANCE\frontend\Website\react\src\assets\theme\base\typography.js", "JavaScript", 148, 0, 0, 0, 21, 31, 200
"c:\Users\abese\Desktop\PROJECTS\FINANCE\frontend\Website\react\src\assets\theme\components\appBar.js", "JavaScript", 11, 0, 0, 0, 14, 4, 29
"c:\Users\abese\Desktop\PROJECTS\FINANCE\frontend\Website\react\src\assets\theme\components\avatar.js", "JavaScript", 16, 0, 0, 0, 15, 7, 38
"c:\Users\abese\Desktop\PROJECTS\FINANCE\frontend\Website\react\src\assets\theme\components\breadcrumbs.js", "JavaScript", 16, 0, 0, 0, 15, 6, 37
"c:\Users\abese\Desktop\PROJECTS\FINANCE\frontend\Website\react\src\assets\theme\components\buttonBase.js", "JavaScript", 6, 0, 0, 0, 14, 3, 23
"c:\Users\abese\Desktop\PROJECTS\FINANCE\frontend\Website\react\src\assets\theme\components\button\contained.js", "JavaScript", 57, 0, 0, 0, 16, 19, 92
"c:\Users\abese\Desktop\PROJECTS\FINANCE\frontend\Website\react\src\assets\theme\components\button\index.js", "JavaScript", 28, 0, 0, 0, 15, 4, 47
"c:\Users\abese\Desktop\PROJECTS\FINANCE\frontend\Website\react\src\assets\theme\components\button\outlined.js", "JavaScript", 51, 0, 0, 0, 16, 16, 83
"c:\Users\abese\Desktop\PROJECTS\FINANCE\frontend\Website\react\src\assets\theme\components\button\root.js", "JavaScript", 30, 0, 0, 0, 16, 8, 54
"c:\Users\abese\Desktop\PROJECTS\FINANCE\frontend\Website\react\src\assets\theme\components\button\text.js", "JavaScript", 68, 0, 0, 0, 16, 21, 105
"c:\Users\abese\Desktop\PROJECTS\FINANCE\frontend\Website\react\src\assets\theme\components\card\cardContent.js", "JavaScript", 11, 0, 0, 0, 15, 4, 30
"c:\Users\abese\Desktop\PROJECTS\FINANCE\frontend\Website\react\src\assets\theme\components\card\cardMedia.js", "JavaScript", 15, 0, 0, 0, 16, 7, 38
"c:\Users\abese\Desktop\PROJECTS\FINANCE\frontend\Website\react\src\assets\theme\components\card\index.js", "JavaScript", 25, 0, 0, 0, 16, 6, 47
"c:\Users\abese\Desktop\PROJECTS\FINANCE\frontend\Website\react\src\assets\theme\components\container.js", "JavaScript", 51, 0, 0, 0, 16, 8, 75
"c:\Users\abese\Desktop\PROJECTS\FINANCE\frontend\Website\react\src\assets\theme\components\dialog\dialogActions.js", "JavaScript", 9, 0, 0, 0, 15, 4, 28
"c:\Users\abese\Desktop\PROJECTS\FINANCE\frontend\Website\react\src\assets\theme\components\dialog\dialogContent.js", "JavaScript", 21, 0, 0, 0, 16, 7, 44
"c:\Users\abese\Desktop\PROJECTS\FINANCE\frontend\Website\react\src\assets\theme\components\dialog\dialogContentText.js", "JavaScript", 13, 0, 0, 0, 17, 6, 36
"c:\Users\abese\Desktop\PROJECTS\FINANCE\frontend\Website\react\src\assets\theme\components\dialog\dialogTitle.js", "JavaScript", 12, 0, 0, 0, 16, 6, 34
"c:\Users\abese\Desktop\PROJECTS\FINANCE\frontend\Website\react\src\assets\theme\components\dialog\index.js", "JavaScript", 16, 0, 0, 0, 15, 6, 37
"c:\Users\abese\Desktop\PROJECTS\FINANCE\frontend\Website\react\src\assets\theme\components\divider.js", "JavaScript", 44, 0, 0, 0, 16, 9, 69
"c:\Users\abese\Desktop\PROJECTS\FINANCE\frontend\Website\react\src\assets\theme\components\flatpickr.js", "JavaScript", 30, 0, 0, 0, 16, 10, 56
"c:\Users\abese\Desktop\PROJECTS\FINANCE\frontend\Website\react\src\assets\theme\components\form\autocomplete.js", "JavaScript", 69, 0, 0, 0, 16, 16, 101
"c:\Users\abese\Desktop\PROJECTS\FINANCE\frontend\Website\react\src\assets\theme\components\form\checkbox.js", "JavaScript", 55, 0, 0, 0, 16, 13, 84
"c:\Users\abese\Desktop\PROJECTS\FINANCE\frontend\Website\react\src\assets\theme\components\form\formControlLabel.js", "JavaScript", 27, 0, 0, 0, 16, 8, 51
"c:\Users\abese\Desktop\PROJECTS\FINANCE\frontend\Website\react\src\assets\theme\components\form\formLabel.js", "JavaScript", 10, 0, 0, 0, 15, 5, 30
"c:\Users\abese\Desktop\PROJECTS\FINANCE\frontend\Website\react\src\assets\theme\components\form\input.js", "JavaScript", 24, 0, 0, 0, 15, 8, 47
"c:\Users\abese\Desktop\PROJECTS\FINANCE\frontend\Website\react\src\assets\theme\components\form\inputLabel.js", "JavaScript", 35, 0, 0, 0, 15, 11, 61
"c:\Users\abese\Desktop\PROJECTS\FINANCE\frontend\Website\react\src\assets\theme\components\form\inputOutlined.js", "JavaScript", 41, 0, 0, 0, 16, 12, 69
"c:\Users\abese\Desktop\PROJECTS\FINANCE\frontend\Website\react\src\assets\theme\components\form\radio.js", "JavaScript", 65, 0, 0, 0, 16, 17, 98
"c:\Users\abese\Desktop\PROJECTS\FINANCE\frontend\Website\react\src\assets\theme\components\form\select.js", "JavaScript", 25, 0, 0, 0, 16, 9, 50
"c:\Users\abese\Desktop\PROJECTS\FINANCE\frontend\Website\react\src\assets\theme\components\form\switchButton.js", "JavaScript", 55, 0, 0, 0, 17, 17, 89
"c:\Users\abese\Desktop\PROJECTS\FINANCE\frontend\Website\react\src\assets\theme\components\form\textField.js", "JavaScript", 10, 0, 0, 0, 15, 5, 30
"c:\Users\abese\Desktop\PROJECTS\FINANCE\frontend\Website\react\src\assets\theme\components\icon.js", "JavaScript", 19, 0, 0, 0, 15, 7, 41
"c:\Users\abese\Desktop\PROJECTS\FINANCE\frontend\Website\react\src\assets\theme\components\iconButton.js", "JavaScript", 12, 0, 0, 0, 15, 5, 32
"c:\Users\abese\Desktop\PROJECTS\FINANCE\frontend\Website\react\src\assets\theme\components\linearProgress.js", "JavaScript", 29, 0, 0, 0, 16, 9, 54
"c:\Users\abese\Desktop\PROJECTS\FINANCE\frontend\Website\react\src\assets\theme\components\link.js", "JavaScript", 7, 0, 0, 0, 14, 3, 24
"c:\Users\abese\Desktop\PROJECTS\FINANCE\frontend\Website\react\src\assets\theme\components\list\index.js", "JavaScript", 9, 0, 0, 0, 14, 3, 26
"c:\Users\abese\Desktop\PROJECTS\FINANCE\frontend\Website\react\src\assets\theme\components\list\listItem.js", "JavaScript", 12, 0, 0, 0, 14, 4, 30
"c:\Users\abese\Desktop\PROJECTS\FINANCE\frontend\Website\react\src\assets\theme\components\list\listItemText.js", "JavaScript", 9, 0, 0, 0, 14, 3, 26
"c:\Users\abese\Desktop\PROJECTS\FINANCE\frontend\Website\react\src\assets\theme\components\menu\index.js", "JavaScript", 27, 0, 0, 0, 16, 7, 50
"c:\Users\abese\Desktop\PROJECTS\FINANCE\frontend\Website\react\src\assets\theme\components\menu\menuItem.js", "JavaScript", 25, 0, 0, 0, 16, 7, 48
"c:\Users\abese\Desktop\PROJECTS\FINANCE\frontend\Website\react\src\assets\theme\components\popover.js", "JavaScript", 18, 0, 0, 0, 16, 6, 40
"c:\Users\abese\Desktop\PROJECTS\FINANCE\frontend\Website\react\src\assets\theme\components\sidenav.js", "JavaScript", 26, 0, 0, 0, 16, 8, 50
"c:\Users\abese\Desktop\PROJECTS\FINANCE\frontend\Website\react\src\assets\theme\components\slider.js", "JavaScript", 52, 0, 0, 0, 16, 14, 82
"c:\Users\abese\Desktop\PROJECTS\FINANCE\frontend\Website\react\src\assets\theme\components\stepper\index.js", "JavaScript", 22, 0, 0, 0, 16, 7, 45
"c:\Users\abese\Desktop\PROJECTS\FINANCE\frontend\Website\react\src\assets\theme\components\stepper\step.js", "JavaScript", 9, 0, 0, 0, 15, 4, 28
"c:\Users\abese\Desktop\PROJECTS\FINANCE\frontend\Website\react\src\assets\theme\components\stepper\stepConnector.js", "JavaScript", 29, 0, 0, 0, 15, 9, 53
"c:\Users\abese\Desktop\PROJECTS\FINANCE\frontend\Website\react\src\assets\theme\components\stepper\stepIcon.js", "JavaScript", 34, 0, 0, 0, 16, 8, 58
"c:\Users\abese\Desktop\PROJECTS\FINANCE\frontend\Website\react\src\assets\theme\components\stepper\stepLabel.js", "JavaScript", 26, 0, 0, 0, 16, 8, 50
"c:\Users\abese\Desktop\PROJECTS\FINANCE\frontend\Website\react\src\assets\theme\components\svgIcon.js", "JavaScript", 18, 0, 0, 0, 15, 7, 40
"c:\Users\abese\Desktop\PROJECTS\FINANCE\frontend\Website\react\src\assets\theme\components\table\tableCell.js", "JavaScript", 14, 0, 0, 0, 16, 6, 36
"c:\Users\abese\Desktop\PROJECTS\FINANCE\frontend\Website\react\src\assets\theme\components\table\tableContainer.js", "JavaScript", 16, 0, 0, 0, 15, 5, 36
"c:\Users\abese\Desktop\PROJECTS\FINANCE\frontend\Website\react\src\assets\theme\components\table\tableHead.js", "JavaScript", 13, 0, 0, 0, 16, 6, 35
"c:\Users\abese\Desktop\PROJECTS\FINANCE\frontend\Website\react\src\assets\theme\components\tabs\index.js", "JavaScript", 40, 0, 0, 0, 16, 10, 66
"c:\Users\abese\Desktop\PROJECTS\FINANCE\frontend\Website\react\src\assets\theme\components\tabs\tab.js", "JavaScript", 41, 0, 0, 0, 16, 9, 66
"c:\Users\abese\Desktop\PROJECTS\FINANCE\frontend\Website\react\src\assets\theme\components\tooltip.js", "JavaScript", 31, 0, 0, 0, 17, 9, 57
"c:\Users\abese\Desktop\PROJECTS\FINANCE\frontend\Website\react\src\assets\theme\functions\boxShadow.js", "JavaScript", 11, 0, 0, 0, 18, 6, 35
"c:\Users\abese\Desktop\PROJECTS\FINANCE\frontend\Website\react\src\assets\theme\functions\gradientChartLine.js", "JavaScript", 11, 0, 0, 0, 18, 7, 36
"c:\Users\abese\Desktop\PROJECTS\FINANCE\frontend\Website\react\src\assets\theme\functions\hexToRgb.js", "JavaScript", 5, 0, 0, 0, 19, 5, 29
"c:\Users\abese\Desktop\PROJECTS\FINANCE\frontend\Website\react\src\assets\theme\functions\linearGradient.js", "JavaScript", 4, 0, 0, 0, 17, 4, 25
"c:\Users\abese\Desktop\PROJECTS\FINANCE\frontend\Website\react\src\assets\theme\functions\pxToRem.js", "JavaScript", 4, 0, 0, 0, 17, 4, 25
"c:\Users\abese\Desktop\PROJECTS\FINANCE\frontend\Website\react\src\assets\theme\functions\rgba.js", "JavaScript", 5, 0, 0, 0, 19, 5, 29
"c:\Users\abese\Desktop\PROJECTS\FINANCE\frontend\Website\react\src\assets\theme\index.js", "JavaScript", 133, 0, 0, 0, 18, 7, 158
"c:\Users\abese\Desktop\PROJECTS\FINANCE\frontend\Website\react\src\assets\theme\theme-rtl.js", "JavaScript", 134, 0, 0, 0, 19, 7, 160
"c:\Users\abese\Desktop\PROJECTS\FINANCE\frontend\Website\react\src\components\MDAlert\MDAlertCloseIcon.js", "JavaScript", 16, 0, 0, 0, 15, 5, 36
"c:\Users\abese\Desktop\PROJECTS\FINANCE\frontend\Website\react\src\components\MDAlert\MDAlertRoot.js", "JavaScript", 27, 0, 0, 0, 16, 6, 49
"c:\Users\abese\Desktop\PROJECTS\FINANCE\frontend\Website\react\src\components\MDAlert\index.js", "JavaScript", 52, 0, 0, 0, 21, 14, 87
"c:\Users\abese\Desktop\PROJECTS\FINANCE\frontend\Website\react\src\components\MDAvatar\MDAvatarRoot.js", "JavaScript", 65, 0, 0, 0, 17, 8, 90
"c:\Users\abese\Desktop\PROJECTS\FINANCE\frontend\Website\react\src\components\MDAvatar\image.js", "JavaScript", 28, 0, 0, 0, 4, 6, 38
"c:\Users\abese\Desktop\PROJECTS\FINANCE\frontend\Website\react\src\components\MDAvatar\index.js", "JavaScript", 27, 0, 0, 0, 18, 8, 53
"c:\Users\abese\Desktop\PROJECTS\FINANCE\frontend\Website\react\src\components\MDBadge\MDBadgeRoot.js", "JavaScript", 93, 0, 0, 0, 24, 18, 135
"c:\Users\abese\Desktop\PROJECTS\FINANCE\frontend\Website\react\src\components\MDBadge\index.js", "JavaScript", 45, 0, 0, 0, 18, 8, 71
"c:\Users\abese\Desktop\PROJECTS\FINANCE\frontend\Website\react\src\components\MDBox\MDBoxRoot.js", "JavaScript", 87, 0, 0, 0, 19, 17, 123
"c:\Users\abese\Desktop\PROJECTS\FINANCE\frontend\Website\react\src\components\MDBox\index.js", "JavaScript", 41, 0, 0, 0, 18, 8, 67
"c:\Users\abese\Desktop\PROJECTS\FINANCE\frontend\Website\react\src\components\MDButton\MDButtonRoot.js", "JavaScript", 188, 0, 0, 0, 40, 49, 277
"c:\Users\abese\Desktop\PROJECTS\FINANCE\frontend\Website\react\src\components\MDButton\index.js", "JavaScript", 48, 0, 0, 0, 19, 10, 77
"c:\Users\abese\Desktop\PROJECTS\FINANCE\frontend\Website\react\src\components\MDInput\MDInputRoot.js", "JavaScript", 44, 0, 0, 0, 17, 11, 72
"c:\Users\abese\Desktop\PROJECTS\FINANCE\frontend\Website\react\src\components\MDInput\index.js", "JavaScript", 17, 0, 0, 0, 18, 8, 43
"c:\Users\abese\Desktop\PROJECTS\FINANCE\frontend\Website\react\src\components\MDPagination\MDPaginationItemRoot.js", "JavaScript", 36, 0, 0, 0, 17, 10, 63
"c:\Users\abese\Desktop\PROJECTS\FINANCE\frontend\Website\react\src\components\MDPagination\index.js", "JavaScript", 64, 0, 0, 0, 20, 12, 96
"c:\Users\abese\Desktop\PROJECTS\FINANCE\frontend\Website\react\src\components\MDProgress\MDProgressRoot.js", "JavaScript", 23, 0, 0, 0, 16, 7, 46
"c:\Users\abese\Desktop\PROJECTS\FINANCE\frontend\Website\react\src\components\MDProgress\index.js", "JavaScript", 42, 0, 0, 0, 19, 9, 70
"c:\Users\abese\Desktop\PROJECTS\FINANCE\frontend\Website\react\src\components\MDSelect\index.js", "JavaScript", 74, 0, 0, 0, 2, 6, 82
"c:\Users\abese\Desktop\PROJECTS\FINANCE\frontend\Website\react\src\components\MDSnackbar\MDSnackbarIconRoot.js", "JavaScript", 25, 0, 0, 0, 16, 7, 48
"c:\Users\abese\Desktop\PROJECTS\FINANCE\frontend\Website\react\src\components\MDSnackbar\index.js", "JavaScript", 139, 0, 0, 0, 21, 15, 175
"c:\Users\abese\Desktop\PROJECTS\FINANCE\frontend\Website\react\src\components\MDTypography\MDTypographyRoot.js", "JavaScript", 40, 0, 0, 0, 18, 9, 67
"c:\Users\abese\Desktop\PROJECTS\FINANCE\frontend\Website\react\src\components\MDTypography\index.js", "JavaScript", 70, 0, 0, 0, 19, 10, 99
"c:\Users\abese\Desktop\PROJECTS\FINANCE\frontend\Website\react\src\context\authContext.js", "JavaScript", 33, 0, 0, 0, 0, 3, 36
"c:\Users\abese\Desktop\PROJECTS\FINANCE\frontend\Website\react\src\context\index.js", "JavaScript", 94, 0, 0, 0, 26, 17, 137
"c:\Users\abese\Desktop\PROJECTS\FINANCE\frontend\Website\react\src\examples\Breadcrumbs\index.js", "JavaScript", 70, 0, 0, 0, 20, 11, 101
"c:\Users\abese\Desktop\PROJECTS\FINANCE\frontend\Website\react\src\examples\Cards\BlogCards\SimpleBlogCard\index.js", "JavaScript", 82, 0, 0, 0, 19, 8, 109
"c:\Users\abese\Desktop\PROJECTS\FINANCE\frontend\Website\react\src\examples\Cards\InfoCards\DefaultInfoCard\index.js", "JavaScript", 57, 0, 0, 0, 19, 8, 84
"c:\Users\abese\Desktop\PROJECTS\FINANCE\frontend\Website\react\src\examples\Cards\InfoCards\ProfileInfoCard\api.js", "JavaScript", 6, 0, 0, 0, 1, 3, 10
"c:\Users\abese\Desktop\PROJECTS\FINANCE\frontend\Website\react\src\examples\Cards\InfoCards\ProfileInfoCard\index.js", "JavaScript", 129, 0, 0, 0, 26, 14, 169
"c:\Users\abese\Desktop\PROJECTS\FINANCE\frontend\Website\react\src\examples\Cards\MasterCard\index.js", "JavaScript", 89, 0, 0, 0, 20, 12, 121
"c:\Users\abese\Desktop\PROJECTS\FINANCE\frontend\Website\react\src\examples\Cards\ProjectCards\DefaultProjectCard\index.js", "JavaScript", 141, 0, 0, 0, 20, 11, 172
"c:\Users\abese\Desktop\PROJECTS\FINANCE\frontend\Website\react\src\examples\Cards\StatisticsCards\ComplexStatisticsCard\index.js", "JavaScript", 89, 0, 0, 0, 19, 8, 116
"c:\Users\abese\Desktop\PROJECTS\FINANCE\frontend\Website\react\src\examples\Charts\BarCharts\HorizontalBarChart\configs\index.js", "JavaScript", 63, 0, 0, 0, 15, 3, 81
"c:\Users\abese\Desktop\PROJECTS\FINANCE\frontend\Website\react\src\examples\Charts\BarCharts\HorizontalBarChart\index.js", "JavaScript", 104, 0, 0, 0, 22, 16, 142
"c:\Users\abese\Desktop\PROJECTS\FINANCE\frontend\Website\react\src\examples\Charts\BarCharts\ReportsBarChart\configs\index.js", "JavaScript", 81, 0, 0, 0, 14, 3, 98
"c:\Users\abese\Desktop\PROJECTS\FINANCE\frontend\Website\react\src\examples\Charts\BarCharts\ReportsBarChart\index.js", "JavaScript", 74, 0, 0, 0, 21, 13, 108
"c:\Users\abese\Desktop\PROJECTS\FINANCE\frontend\Website\react\src\examples\Charts\BarCharts\VerticalBarChart\configs\index.js", "JavaScript", 60, 0, 0, 0, 15, 4, 79
"c:\Users\abese\Desktop\PROJECTS\FINANCE\frontend\Website\react\src\examples\Charts\BarCharts\VerticalBarChart\index.js", "JavaScript", 112, 0, 0, 0, 8, 15, 135
"c:\Users\abese\Desktop\PROJECTS\FINANCE\frontend\Website\react\src\examples\Charts\BubbleChart\configs\index.js", "JavaScript", 65, 0, 0, 0, 15, 4, 84
"c:\Users\abese\Desktop\PROJECTS\FINANCE\frontend\Website\react\src\examples\Charts\BubbleChart\index.js", "JavaScript", 98, 0, 0, 0, 22, 16, 136
"c:\Users\abese\Desktop\PROJECTS\FINANCE\frontend\Website\react\src\examples\Charts\DoughnutCharts\DefaultDoughnutChart\configs\index.js", "JavaScript", 52, 0, 0, 0, 16, 7, 75
"c:\Users\abese\Desktop\PROJECTS\FINANCE\frontend\Website\react\src\examples\Charts\DoughnutCharts\DefaultDoughnutChart\index.js", "JavaScript", 82, 0, 0, 0, 21, 14, 117
"c:\Users\abese\Desktop\PROJECTS\FINANCE\frontend\Website\react\src\examples\Charts\LineCharts\DefaultLineChart\configs\index.js", "JavaScript", 67, 0, 0, 0, 15, 3, 85
"c:\Users\abese\Desktop\PROJECTS\FINANCE\frontend\Website\react\src\examples\Charts\LineCharts\DefaultLineChart\index.js", "JavaScript", 119, 0, 0, 0, 22, 16, 157
"c:\Users\abese\Desktop\PROJECTS\FINANCE\frontend\Website\react\src\examples\Charts\LineCharts\GradientLineChart\configs\index.js", "JavaScript", 65, 0, 0, 0, 15, 4, 84
"c:\Users\abese\Desktop\PROJECTS\FINANCE\frontend\Website\react\src\examples\Charts\LineCharts\GradientLineChart\index.js", "JavaScript", 130, 0, 0, 0, 23, 21, 174
"c:\Users\abese\Desktop\PROJECTS\FINANCE\frontend\Website\react\src\examples\Charts\LineCharts\ProgressLineChart\config\index.js", "JavaScript", 81, 0, 0, 0, 16, 6, 103
"c:\Users\abese\Desktop\PROJECTS\FINANCE\frontend\Website\react\src\examples\Charts\LineCharts\ProgressLineChart\index.js", "JavaScript", 99, 0, 0, 0, 21, 13, 133
"c:\Users\abese\Desktop\PROJECTS\FINANCE\frontend\Website\react\src\examples\Charts\LineCharts\ReportsLineChart\configs\index.js", "JavaScript", 81, 0, 0, 0, 14, 3, 98
"c:\Users\abese\Desktop\PROJECTS\FINANCE\frontend\Website\react\src\examples\Charts\LineCharts\ReportsLineChart\index.js", "JavaScript", 85, 0, 0, 0, 21, 13, 119
"c:\Users\abese\Desktop\PROJECTS\FINANCE\frontend\Website\react\src\examples\Charts\MixedChart\configs\index.js", "JavaScript", 65, 0, 0, 0, 15, 4, 84
"c:\Users\abese\Desktop\PROJECTS\FINANCE\frontend\Website\react\src\examples\Charts\MixedChart\index.js", "JavaScript", 186, 0, 0, 0, 23, 27, 236
"c:\Users\abese\Desktop\PROJECTS\FINANCE\frontend\Website\react\src\examples\Charts\PieChart\configs\index.js", "JavaScript", 54, 0, 0, 0, 0, 6, 60
"c:\Users\abese\Desktop\PROJECTS\FINANCE\frontend\Website\react\src\examples\Charts\PieChart\index.js", "JavaScript", 82, 0, 0, 0, 21, 14, 117
"c:\Users\abese\Desktop\PROJECTS\FINANCE\frontend\Website\react\src\examples\Charts\PolarChart\configs\index.js", "JavaScript", 40, 0, 0, 0, 16, 7, 63
"c:\Users\abese\Desktop\PROJECTS\FINANCE\frontend\Website\react\src\examples\Charts\PolarChart\index.js", "JavaScript", 81, 0, 0, 0, 21, 14, 116
"c:\Users\abese\Desktop\PROJECTS\FINANCE\frontend\Website\react\src\examples\Charts\RadarChart\configs\index.js", "JavaScript", 22, 0, 0, 0, 14, 3, 39
"c:\Users\abese\Desktop\PROJECTS\FINANCE\frontend\Website\react\src\examples\Charts\RadarChart\index.js", "JavaScript", 99, 0, 0, 0, 23, 17, 139
"c:\Users\abese\Desktop\PROJECTS\FINANCE\frontend\Website\react\src\examples\Configurator\ConfiguratorRoot.js", "JavaScript", 37, 0, 0, 0, 17, 7, 61
"c:\Users\abese\Desktop\PROJECTS\FINANCE\frontend\Website\react\src\examples\Configurator\index.js", "JavaScript", 233, 0, 0, 0, 25, 30, 288
"c:\Users\abese\Desktop\PROJECTS\FINANCE\frontend\Website\react\src\examples\Error\index.js", "JavaScript", 21, 0, 0, 0, 3, 5, 29
"c:\Users\abese\Desktop\PROJECTS\FINANCE\frontend\Website\react\src\examples\Footer\index.js", "JavaScript", 74, 0, 0, 0, 20, 12, 106
"c:\Users\abese\Desktop\PROJECTS\FINANCE\frontend\Website\react\src\examples\Items\NotificationItem\index.js", "JavaScript", 24, 0, 0, 0, 19, 9, 52
"c:\Users\abese\Desktop\PROJECTS\FINANCE\frontend\Website\react\src\examples\Items\NotificationItem\styles.js", "JavaScript", 29, 0, 0, 0, 0, 8, 37
"c:\Users\abese\Desktop\PROJECTS\FINANCE\frontend\Website\react\src\examples\Language\LanguageSwitcher.js", "JavaScript", 18, 0, 0, 0, 1, 3, 22
"c:\Users\abese\Desktop\PROJECTS\FINANCE\frontend\Website\react\src\examples\LayoutContainers\DashboardLayout\index.js", "JavaScript", 34, 0, 0, 0, 19, 12, 65
"c:\Users\abese\Desktop\PROJECTS\FINANCE\frontend\Website\react\src\examples\LayoutContainers\PageLayout\index.js", "JavaScript", 31, 0, 0, 0, 20, 12, 63
"c:\Users\abese\Desktop\PROJECTS\FINANCE\frontend\Website\react\src\examples\Lists\ProfilesList\index.js", "JavaScript", 65, 0, 0, 0, 20, 10, 95
"c:\Users\abese\Desktop\PROJECTS\FINANCE\frontend\Website\react\src\examples\Loading\index.js", "JavaScript", 52, 0, 0, 0, 2, 8, 62
"c:\Users\abese\Desktop\PROJECTS\FINANCE\frontend\Website\react\src\examples\Navbars\DashboardNavbar\index.js", "JavaScript", 175, 0, 0, 0, 30, 21, 226
"c:\Users\abese\Desktop\PROJECTS\FINANCE\frontend\Website\react\src\examples\Navbars\DashboardNavbar\styles.js", "JavaScript", 100, 0, 0, 0, 14, 21, 135
"c:\Users\abese\Desktop\PROJECTS\FINANCE\frontend\Website\react\src\examples\Navbars\DefaultNavbar\DefaultNavbarLink.js", "JavaScript", 43, 0, 0, 0, 19, 8, 70
"c:\Users\abese\Desktop\PROJECTS\FINANCE\frontend\Website\react\src\examples\Navbars\DefaultNavbar\DefaultNavbarMobile.js", "JavaScript", 32, 0, 0, 0, 23, 9, 64
"c:\Users\abese\Desktop\PROJECTS\FINANCE\frontend\Website\react\src\examples\Navbars\DefaultNavbar\index.js", "JavaScript", 146, 0, 0, 0, 44, 20, 210
"c:\Users\abese\Desktop\PROJECTS\FINANCE\frontend\Website\react\src\examples\Sidenav\SidenavCollapse.js", "JavaScript", 99, 0, 0, 0, 23, 14, 136
"c:\Users\abese\Desktop\PROJECTS\FINANCE\frontend\Website\react\src\examples\Sidenav\SidenavRoot.js", "JavaScript", 64, 0, 0, 0, 17, 12, 93
"c:\Users\abese\Desktop\PROJECTS\FINANCE\frontend\Website\react\src\examples\Sidenav\index.js", "JavaScript", 191, 0, 0, 0, 30, 23, 244
"c:\Users\abese\Desktop\PROJECTS\FINANCE\frontend\Website\react\src\examples\Sidenav\styles\sidenav.js", "JavaScript", 18, 0, 0, 0, 14, 4, 36
"c:\Users\abese\Desktop\PROJECTS\FINANCE\frontend\Website\react\src\examples\Sidenav\styles\sidenavCollapse.js", "JavaScript", 97, 0, 0, 0, 14, 17, 128
"c:\Users\abese\Desktop\PROJECTS\FINANCE\frontend\Website\react\src\examples\Tables\DataTable\DataTableBodyCell.js", "JavaScript", 35, 0, 0, 0, 18, 7, 60
"c:\Users\abese\Desktop\PROJECTS\FINANCE\frontend\Website\react\src\examples\Tables\DataTable\DataTableHeadCell.js", "JavaScript", 76, 0, 0, 0, 20, 10, 106
"c:\Users\abese\Desktop\PROJECTS\FINANCE\frontend\Website\react\src\examples\Tables\DataTable\index.js", "JavaScript", 251, 0, 0, 0, 32, 29, 312
"c:\Users\abese\Desktop\PROJECTS\FINANCE\frontend\Website\react\src\examples\Timeline\TimelineItem\index.js", "JavaScript", 70, 0, 0, 0, 21, 11, 102
"c:\Users\abese\Desktop\PROJECTS\FINANCE\frontend\Website\react\src\examples\Timeline\TimelineItem\styles.js", "JavaScript", 17, 0, 0, 0, 0, 4, 21
"c:\Users\abese\Desktop\PROJECTS\FINANCE\frontend\Website\react\src\examples\Timeline\TimelineList\index.js", "JavaScript", 38, 0, 0, 0, 21, 11, 70
"c:\Users\abese\Desktop\PROJECTS\FINANCE\frontend\Website\react\src\examples\Timeline\context\index.js", "JavaScript", 9, 0, 0, 0, 22, 7, 38
"c:\Users\abese\Desktop\PROJECTS\FINANCE\frontend\Website\react\src\firebase.js", "JavaScript", 12, 0, 0, 0, 0, 3, 15
"c:\Users\abese\Desktop\PROJECTS\FINANCE\frontend\Website\react\src\i18n.js", "JavaScript", 61, 0, 0, 0, 1, 7, 69
"c:\Users\abese\Desktop\PROJECTS\FINANCE\frontend\Website\react\src\index.js", "JavaScript", 22, 0, 0, 0, 15, 6, 43
"c:\Users\abese\Desktop\PROJECTS\FINANCE\frontend\Website\react\src\layouts\analytics\api.js", "JavaScript", 32, 0, 0, 0, 1, 8, 41
"c:\Users\abese\Desktop\PROJECTS\FINANCE\frontend\Website\react\src\layouts\analytics\index.js", "JavaScript", 344, 0, 0, 0, 3, 12, 359
"c:\Users\abese\Desktop\PROJECTS\FINANCE\frontend\Website\react\src\layouts\authentication\components\BasicLayout\index.js", "JavaScript", 42, 0, 0, 0, 20, 9, 71
"c:\Users\abese\Desktop\PROJECTS\FINANCE\frontend\Website\react\src\layouts\authentication\components\CoverLayout\index.js", "JavaScript", 58, 0, 0, 0, 22, 10, 90
"c:\Users\abese\Desktop\PROJECTS\FINANCE\frontend\Website\react\src\layouts\authentication\components\Footer\index.js", "JavaScript", 74, 0, 0, 0, 20, 11, 105
"c:\Users\abese\Desktop\PROJECTS\FINANCE\frontend\Website\react\src\layouts\authentication\sign-in\index.js", "JavaScript", 212, 0, 0, 0, 20, 14, 246
"c:\Users\abese\Desktop\PROJECTS\FINANCE\frontend\Website\react\src\layouts\dashboard\api.js", "JavaScript", 32, 0, 0, 0, 1, 6, 39
"c:\Users\abese\Desktop\PROJECTS\FINANCE\frontend\Website\react\src\layouts\dashboard\index.js", "JavaScript", 157, 0, 0, 0, 17, 11, 185
"c:\Users\abese\Desktop\PROJECTS\FINANCE\frontend\Website\react\src\layouts\departments\dialog.js", "JavaScript", 95, 0, 0, 0, 2, 3, 100
"c:\Users\abese\Desktop\PROJECTS\FINANCE\frontend\Website\react\src\layouts\departments\index.js", "JavaScript", 126, 0, 0, 0, 1, 8, 135
"c:\Users\abese\Desktop\PROJECTS\FINANCE\frontend\Website\react\src\layouts\details\index.js", "JavaScript", 283, 0, 0, 0, 17, 9, 309
"c:\Users\abese\Desktop\PROJECTS\FINANCE\frontend\Website\react\src\layouts\details\resume.js", "JavaScript", 202, 0, 0, 0, 1, 5, 208
"c:\Users\abese\Desktop\PROJECTS\FINANCE\frontend\Website\react\src\layouts\devices\api.js", "JavaScript", 27, 0, 0, 0, 1, 8, 36
"c:\Users\abese\Desktop\PROJECTS\FINANCE\frontend\Website\react\src\layouts\devices\index.js", "JavaScript", 138, 0, 0, 0, 1, 11, 150
"c:\Users\abese\Desktop\PROJECTS\FINANCE\frontend\Website\react\src\layouts\documents\components\Bill\index.js", "JavaScript", 80, 0, 0, 0, 20, 11, 111
"c:\Users\abese\Desktop\PROJECTS\FINANCE\frontend\Website\react\src\layouts\documents\components\BillingInformation\index.js", "JavaScript", 39, 0, 0, 0, 17, 6, 62
"c:\Users\abese\Desktop\PROJECTS\FINANCE\frontend\Website\react\src\layouts\documents\components\Invoice\index.js", "JavaScript", 47, 0, 0, 0, 19, 8, 74
"c:\Users\abese\Desktop\PROJECTS\FINANCE\frontend\Website\react\src\layouts\documents\components\Invoices\index.js", "JavaScript", 29, 0, 0, 0, 17, 6, 52
"c:\Users\abese\Desktop\PROJECTS\FINANCE\frontend\Website\react\src\layouts\documents\components\OrdersOverview\index.js", "JavaScript", 62, 0, 0, 0, 17, 6, 85
"c:\Users\abese\Desktop\PROJECTS\FINANCE\frontend\Website\react\src\layouts\documents\components\Projects\data\index.js", "JavaScript", 184, 0, 0, 0, 18, 9, 211
"c:\Users\abese\Desktop\PROJECTS\FINANCE\frontend\Website\react\src\layouts\documents\components\Projects\index.js", "JavaScript", 114, 0, 0, 0, 18, 10, 142
"c:\Users\abese\Desktop\PROJECTS\FINANCE\frontend\Website\react\src\layouts\documents\components\RecentDocument\index.js", "JavaScript", 68, 0, 0, 0, 19, 10, 97
"c:\Users\abese\Desktop\PROJECTS\FINANCE\frontend\Website\react\src\layouts\documents\components\Transaction\index.js", "JavaScript", 48, 0, 0, 0, 18, 7, 73
"c:\Users\abese\Desktop\PROJECTS\FINANCE\frontend\Website\react\src\layouts\documents\components\Transactions\index.js", "JavaScript", 99, 0, 0, 0, 19, 6, 124
"c:\Users\abese\Desktop\PROJECTS\FINANCE\frontend\Website\react\src\layouts\documents\components\form\page1\index.js", "JavaScript", 225, 0, 0, 0, 20, 4, 249
"c:\Users\abese\Desktop\PROJECTS\FINANCE\frontend\Website\react\src\layouts\documents\components\form\page2\index.js", "JavaScript", 165, 0, 0, 0, 2, 4, 171
"c:\Users\abese\Desktop\PROJECTS\FINANCE\frontend\Website\react\src\layouts\documents\components\form\page2\languageForm.js", "JavaScript", 164, 0, 0, 0, 1, 5, 170
"c:\Users\abese\Desktop\PROJECTS\FINANCE\frontend\Website\react\src\layouts\documents\components\form\page3\fileupload.js", "JavaScript", 135, 0, 0, 0, 7, 20, 162
"c:\Users\abese\Desktop\PROJECTS\FINANCE\frontend\Website\react\src\layouts\documents\components\form\page3\index.js", "JavaScript", 154, 0, 0, 0, 2, 4, 160
"c:\Users\abese\Desktop\PROJECTS\FINANCE\frontend\Website\react\src\layouts\documents\components\form\page3\styles.css", "CSS", 0, 0, 7, 0, 0, 2, 9
"c:\Users\abese\Desktop\PROJECTS\FINANCE\frontend\Website\react\src\layouts\documents\index.js", "JavaScript", 129, 0, 0, 0, 27, 17, 173
"c:\Users\abese\Desktop\PROJECTS\FINANCE\frontend\Website\react\src\layouts\language\api.js", "JavaScript", 49, 0, 0, 0, 1, 5, 55
"c:\Users\abese\Desktop\PROJECTS\FINANCE\frontend\Website\react\src\layouts\language\index.js", "JavaScript", 229, 0, 0, 0, 4, 11, 244
"c:\Users\abese\Desktop\PROJECTS\FINANCE\frontend\Website\react\src\layouts\notifications\index.js", "JavaScript", 173, 0, 0, 0, 18, 16, 207
"c:\Users\abese\Desktop\PROJECTS\FINANCE\frontend\Website\react\src\layouts\ordering\card.js", "JavaScript", 163, 0, 0, 0, 18, 1, 182
"c:\Users\abese\Desktop\PROJECTS\FINANCE\frontend\Website\react\src\layouts\ordering\index.js", "JavaScript", 366, 0, 0, 0, 3, 13, 382
"c:\Users\abese\Desktop\PROJECTS\FINANCE\frontend\Website\react\src\layouts\ordering\itemTypes.js", "JavaScript", 3, 0, 0, 0, 0, 1, 4
"c:\Users\abese\Desktop\PROJECTS\FINANCE\frontend\Website\react\src\layouts\permissions\api.js", "JavaScript", 141, 0, 0, 0, 10, 20, 171
"c:\Users\abese\Desktop\PROJECTS\FINANCE\frontend\Website\react\src\layouts\permissions\index.js", "JavaScript", 257, 0, 0, 0, 4, 12, 273
"c:\Users\abese\Desktop\PROJECTS\FINANCE\frontend\Website\react\src\layouts\profile\components\Header\index.js", "JavaScript", 94, 0, 0, 0, 51, 16, 161
"c:\Users\abese\Desktop\PROJECTS\FINANCE\frontend\Website\react\src\layouts\profile\components\PlatformSettings\index.js", "JavaScript", 93, 0, 0, 0, 16, 7, 116
"c:\Users\abese\Desktop\PROJECTS\FINANCE\frontend\Website\react\src\layouts\profile\data\profilesListData.js", "JavaScript", 62, 0, 0, 0, 15, 3, 80
"c:\Users\abese\Desktop\PROJECTS\FINANCE\frontend\Website\react\src\layouts\profile\index.js", "JavaScript", 54, 0, 0, 0, 20, 9, 83
"c:\Users\abese\Desktop\PROJECTS\FINANCE\frontend\Website\react\src\layouts\request\capital request\components\dialog\dialog.js", "JavaScript", 254, 0, 0, 0, 1, 5, 260
"c:\Users\abese\Desktop\PROJECTS\FINANCE\frontend\Website\react\src\layouts\request\capital request\components\dialog\dialogdetail.js", "JavaScript", 309, 0, 0, 0, 4, 11, 324
"c:\Users\abese\Desktop\PROJECTS\FINANCE\frontend\Website\react\src\layouts\request\capital request\components\userform\index.js", "JavaScript", 86, 0, 0, 0, 2, 6, 94
"c:\Users\abese\Desktop\PROJECTS\FINANCE\frontend\Website\react\src\layouts\request\capital request\index.js", "JavaScript", 355, 0, 0, 0, 26, 28, 409
"c:\Users\abese\Desktop\PROJECTS\FINANCE\frontend\Website\react\src\layouts\request\capital request\template.json", "JSON", 0, 1, 0, 0, 0, 0, 1
"c:\Users\abese\Desktop\PROJECTS\FINANCE\frontend\Website\react\src\layouts\request\internal request\components\dialog\dialog.js", "JavaScript", 156, 0, 0, 0, 1, 3, 160
"c:\Users\abese\Desktop\PROJECTS\FINANCE\frontend\Website\react\src\layouts\request\internal request\components\dialog\dialogdetail.js", "JavaScript", 297, 0, 0, 0, 1, 9, 307
"c:\Users\abese\Desktop\PROJECTS\FINANCE\frontend\Website\react\src\layouts\request\internal request\components\userform\index.js", "JavaScript", 86, 0, 0, 0, 2, 6, 94
"c:\Users\abese\Desktop\PROJECTS\FINANCE\frontend\Website\react\src\layouts\request\internal request\index.js", "JavaScript", 320, 0, 0, 0, 26, 21, 367
"c:\Users\abese\Desktop\PROJECTS\FINANCE\frontend\Website\react\src\layouts\request\internal request\template.json", "JSON", 0, 1, 0, 0, 0, 0, 1
"c:\Users\abese\Desktop\PROJECTS\FINANCE\frontend\Website\react\src\layouts\request\normal request\components\dialog\dialog.js", "JavaScript", 255, 0, 0, 0, 1, 5, 261
"c:\Users\abese\Desktop\PROJECTS\FINANCE\frontend\Website\react\src\layouts\request\normal request\components\dialog\dialogdetail.js", "JavaScript", 297, 0, 0, 0, 1, 9, 307
"c:\Users\abese\Desktop\PROJECTS\FINANCE\frontend\Website\react\src\layouts\request\normal request\components\userform\index.js", "JavaScript", 86, 0, 0, 0, 2, 6, 94
"c:\Users\abese\Desktop\PROJECTS\FINANCE\frontend\Website\react\src\layouts\request\normal request\index.js", "JavaScript", 358, 0, 0, 0, 23, 26, 407
"c:\Users\abese\Desktop\PROJECTS\FINANCE\frontend\Website\react\src\layouts\request\treasury request\components\dialog\dialog.js", "JavaScript", 334, 0, 0, 0, 7, 9, 350
"c:\Users\abese\Desktop\PROJECTS\FINANCE\frontend\Website\react\src\layouts\request\treasury request\components\dialog\dialogdetail.js", "JavaScript", 328, 0, 0, 0, 2, 7, 337
"c:\Users\abese\Desktop\PROJECTS\FINANCE\frontend\Website\react\src\layouts\request\treasury request\components\userform\index.js", "JavaScript", 86, 0, 0, 0, 2, 6, 94
"c:\Users\abese\Desktop\PROJECTS\FINANCE\frontend\Website\react\src\layouts\request\treasury request\index.js", "JavaScript", 276, 0, 0, 0, 67, 27, 370
"c:\Users\abese\Desktop\PROJECTS\FINANCE\frontend\Website\react\src\layouts\rtl\components\OrdersOverview\index.js", "JavaScript", 62, 0, 0, 0, 17, 6, 85
"c:\Users\abese\Desktop\PROJECTS\FINANCE\frontend\Website\react\src\layouts\rtl\components\Projects\data\index.js", "JavaScript", 184, 0, 0, 0, 19, 10, 213
"c:\Users\abese\Desktop\PROJECTS\FINANCE\frontend\Website\react\src\layouts\rtl\components\Projects\index.js", "JavaScript", 76, 0, 0, 0, 17, 10, 103
"c:\Users\abese\Desktop\PROJECTS\FINANCE\frontend\Website\react\src\layouts\rtl\data\reportsBarChartData.js", "JavaScript", 4, 0, 0, 0, 14, 2, 20
"c:\Users\abese\Desktop\PROJECTS\FINANCE\frontend\Website\react\src\layouts\rtl\data\reportsLineChartData.js", "JavaScript", 10, 0, 0, 0, 14, 2, 26
"c:\Users\abese\Desktop\PROJECTS\FINANCE\frontend\Website\react\src\layouts\rtl\index.js", "JavaScript", 150, 0, 0, 0, 22, 14, 186
"c:\Users\abese\Desktop\PROJECTS\FINANCE\frontend\Website\react\src\layouts\search\components\Bill\index.js", "JavaScript", 80, 0, 0, 0, 20, 11, 111
"c:\Users\abese\Desktop\PROJECTS\FINANCE\frontend\Website\react\src\layouts\search\components\BillingInformation\index.js", "JavaScript", 39, 0, 0, 0, 17, 6, 62
"c:\Users\abese\Desktop\PROJECTS\FINANCE\frontend\Website\react\src\layouts\search\components\Invoice\index.js", "JavaScript", 47, 0, 0, 0, 19, 8, 74
"c:\Users\abese\Desktop\PROJECTS\FINANCE\frontend\Website\react\src\layouts\search\components\Invoices\index.js", "JavaScript", 29, 0, 0, 0, 17, 6, 52
"c:\Users\abese\Desktop\PROJECTS\FINANCE\frontend\Website\react\src\layouts\search\components\OrdersOverview\index.js", "JavaScript", 62, 0, 0, 0, 17, 6, 85
"c:\Users\abese\Desktop\PROJECTS\FINANCE\frontend\Website\react\src\layouts\search\components\Projects\data\index.js", "JavaScript", 184, 0, 0, 0, 18, 9, 211
"c:\Users\abese\Desktop\PROJECTS\FINANCE\frontend\Website\react\src\layouts\search\components\Projects\index.js", "JavaScript", 75, 0, 0, 0, 19, 10, 104
"c:\Users\abese\Desktop\PROJECTS\FINANCE\frontend\Website\react\src\layouts\search\components\RecentDocument\index.js", "JavaScript", 68, 0, 0, 0, 19, 10, 97
"c:\Users\abese\Desktop\PROJECTS\FINANCE\frontend\Website\react\src\layouts\search\components\Transaction\index.js", "JavaScript", 48, 0, 0, 0, 18, 7, 73
"c:\Users\abese\Desktop\PROJECTS\FINANCE\frontend\Website\react\src\layouts\search\components\Transactions\index.js", "JavaScript", 99, 0, 0, 0, 19, 6, 124
"c:\Users\abese\Desktop\PROJECTS\FINANCE\frontend\Website\react\src\layouts\search\components\form\page1\index.js", "JavaScript", 197, 0, 0, 0, 3, 7, 207
"c:\Users\abese\Desktop\PROJECTS\FINANCE\frontend\Website\react\src\layouts\search\components\form\page2\index.js", "JavaScript", 127, 0, 0, 0, 2, 5, 134
"c:\Users\abese\Desktop\PROJECTS\FINANCE\frontend\Website\react\src\layouts\search\components\form\page2\languageForm.js", "JavaScript", 160, 0, 0, 0, 1, 5, 166
"c:\Users\abese\Desktop\PROJECTS\FINANCE\frontend\Website\react\src\layouts\search\components\form\page3\fileupload.js", "JavaScript", 33, 0, 0, 0, 2, 7, 42
"c:\Users\abese\Desktop\PROJECTS\FINANCE\frontend\Website\react\src\layouts\search\components\form\page3\index.js", "JavaScript", 154, 0, 0, 0, 2, 5, 161
"c:\Users\abese\Desktop\PROJECTS\FINANCE\frontend\Website\react\src\layouts\search\idcard.js", "JavaScript", 35, 0, 0, 0, 1, 5, 41
"c:\Users\abese\Desktop\PROJECTS\FINANCE\frontend\Website\react\src\layouts\search\index.js", "JavaScript", 108, 0, 0, 0, 16, 8, 132
"c:\Users\abese\Desktop\PROJECTS\FINANCE\frontend\Website\react\src\layouts\search\lazyimage.js", "JavaScript", 23, 0, 0, 0, 1, 3, 27
"c:\Users\abese\Desktop\PROJECTS\FINANCE\frontend\Website\react\src\layouts\share\index.js", "JavaScript", 131, 0, 0, 0, 15, 8, 154
"c:\Users\abese\Desktop\PROJECTS\FINANCE\frontend\Website\react\src\layouts\trasury managment\components\codemanager\index.js", "JavaScript", 264, 0, 0, 0, 11, 17, 292
"c:\Users\abese\Desktop\PROJECTS\FINANCE\frontend\Website\react\src\layouts\trasury managment\components\modal\index.js", "JavaScript", 40, 0, 0, 0, 116, 4, 160
"c:\Users\abese\Desktop\PROJECTS\FINANCE\frontend\Website\react\src\layouts\trasury managment\index.js", "JavaScript", 164, 0, 0, 0, 38, 16, 218
"c:\Users\abese\Desktop\PROJECTS\FINANCE\frontend\Website\react\src\layouts\users\components\modal\index.js", "JavaScript", 19, 0, 0, 0, 94, 3, 116
"c:\Users\abese\Desktop\PROJECTS\FINANCE\frontend\Website\react\src\layouts\users\components\userform\index.js", "JavaScript", 89, 0, 0, 0, 40, 4, 133
"c:\Users\abese\Desktop\PROJECTS\FINANCE\frontend\Website\react\src\layouts\users\index.js", "JavaScript", 347, 0, 0, 0, 21, 19, 387
"c:\Users\abese\Desktop\PROJECTS\FINANCE\frontend\Website\react\src\routes.js", "JavaScript", 157, 0, 0, 0, 37, 6, 200
"Total", "-", 23505, 2, 7, 260, 5183, 2998, 31955